1111111111
1P00000001
1110111101
1C01000001
1010111101
1000100001
1110101011
1C000100E1
1000000011
1111111111
