111111111111111
1P0000000010001
101111111101111
1C0001000010001
111101111101011
1C0000001000011
111110111101111
100000100001C01
101111101111101
100000001000001
101011111011111
100010000000001
101110111111101
1C00000000000E1
111111111111111
