11111
1P0E1
10001
1C0C1
11111
