11111
1P0E1
11111
1C0C1
11111
