11111111111111111111
1P0E0000000000000001
10000000000000000001
10000000000000000001
11111111111111111111
