11111
100E1
10001
1C0C1
11111
