11111
1PPE1
10001
1C0C1
11111
