11111
1PEE1
10001
1C0C1
11111
